7
6
3,3,3,4,3,3,3,
3,0,6,6,6,6,3,
3,6,0,6,6,6,3,
3,6,6,6,6,9,3,
3,6,6,6,6,6,3,
3,3,3,3,3,3,3,